##########################################
#                                        #
#                                        #
#                                        #
#                                        #
#             @                          #
#                                        #
#                                        #
#                                        #
#                                        #
#                                        #
#                                        #
#                                        #
#                                        #
#                                        #
##########################################