##########################################
#                       #                #
#                       #                #
#                       #                #
#                       #                #
#             @         #                #
#                       #                #
#                       #                #
#       #                                #
#       #                                #
#       #                                #
#       #               ##################
#       #                                #
#       #                                #
#       #                                #
##########################################